-37 -37 -37 -37 -37 -37 -37 -37 -37 -37 -37 -37 -37 -37 -37 -37 -37 -37 -37 -37 -37 -37 -37 -37 -37 -37 -37 -37 -37 -37 -37 -37 -37 -37 -37 -37 -37 -37 -37 -37 -37 -37 -37 -37 -37 -37 -37 -37 -37 -37 
-37 32 32 32 32 32 32 32 32 32 32 32 32 32 32 32 32 32 32 32 32 32 32 32 32 32 32 32 32 32 32 32 32 32 32 32 32 32 32 -37 32 32 32 32 32 32 32 32 32 -37 
-37 32 32 32 32 32 32 32 32 32 32 32 32 32 32 32 32 32 32 32 32 32 32 32 32 32 32 32 32 32 32 32 32 32 32 32 32 32 32 -37 32 32 32 32 32 32 32 32 32 -37 
-37 32 32 32 32 32 32 32 32 32 32 32 32 32 32 32 32 32 32 32 32 32 32 32 32 32 32 32 32 32 32 32 32 32 32 32 32 32 32 -37 32 32 32 32 32 32 32 32 32 -37 
-37 32 32 32 32 32 32 32 32 32 32 32 32 32 32 32 32 32 32 32 32 32 32 32 32 32 32 32 32 32 32 32 32 32 32 32 32 32 32 -37 32 32 32 32 32 32 32 32 32 -37 
-37 32 32 32 32 32 32 32 32 32 32 32 32 32 32 32 32 32 32 32 32 32 32 32 32 32 32 32 32 32 32 32 32 32 32 32 32 32 32 -37 32 32 32 32 32 32 32 32 32 -37 
-37 32 32 32 32 32 32 32 32 32 32 32 32 32 32 32 32 32 32 32 32 32 32 32 32 32 32 32 32 32 32 32 32 32 32 32 32 32 32 -37 32 32 32 32 32 32 32 32 32 -37 
-37 32 32 32 32 32 32 32 32 32 32 32 32 32 32 32 32 32 32 32 32 32 32 32 32 32 32 32 32 32 32 32 32 32 32 32 32 32 32 -37 -37 -37 -37 -37 -37 -37 -37 -37 -37 -37 
-37 32 32 32 -78 -78 -78 -78 32 32 32 32 32 32 32 32 32 32 32 32 32 32 32 32 32 32 32 32 32 32 32 32 32 32 32 32 32 32 32 -37 32 32 32 32 32 32 32 32 32 -37 
-37 32 32 32 -78 -78 -78 -78 32 32 32 32 32 32 -80 -80 -80 -80 -80 -80 -80 32 32 32 32 32 32 32 32 32 32 32 32 32 32 32 32 32 32 -37 32 32 32 32 32 32 32 32 32 -37 
-37 -78 -78 -78 -78 -78 -78 -78 32 32 32 32 32 32 -80 -80 -80 -80 -80 -80 -80 32 32 32 32 32 32 -78 -78 -78 -78 -78 -78 -78 -78 -78 32 32 32 -37 32 32 32 32 32 32 32 32 32 -37 
-37 -78 -78 -78 -78 -78 -78 -78 32 32 32 32 32 32 -80 -80 -80 -80 -80 -80 -80 32 32 32 32 32 32 -78 -78 -78 -78 -78 -78 -78 -78 -78 32 32 32 -37 32 32 32 32 32 32 32 32 32 -37 
-37 -78 -78 -78 -78 -78 -78 -78 32 32 32 32 32 32 32 32 32 32 32 32 32 32 32 32 32 32 32 32 32 -37 -37 -37 -37 -37 -37 -37 -37 -78 32 -37 32 32 32 32 32 32 32 32 32 -37 
-37 32 32 32 32 32 32 32 -37 -37 -37 32 32 32 -78 -78 -78 -78 -78 -78 32 32 32 -37 -37 -37 32 32 32 32 32 32 32 32 32 32 32 32 32 -37 32 32 32 32 32 32 32 32 32 -37 
-37 32 32 32 32 32 32 32 32 32 32 32 32 32 -78 -78 -78 -78 -78 -78 32 32 32 32 32 32 32 32 32 32 32 32 -78 -78 -78 -78 -78 -78 32 -37 32 32 32 32 32 32 32 32 32 -37 
-37 32 32 32 32 32 32 32 32 32 32 32 32 32 32 32 32 32 32 32 32 32 32 32 32 32 32 32 32 32 32 32 32 32 32 32 32 32 32 -37 32 32 32 32 32 32 32 32 32 -37 
-37 32 32 32 32 32 32 32 32 32 32 32 32 32 32 32 32 32 32 32 32 32 32 32 32 32 -80 -80 -80 -80 -80 -80 -80 32 32 32 32 32 32 -37 32 32 32 32 32 32 32 32 32 -37 
-37 32 32 32 32 32 32 32 32 32 32 32 32 32 32 32 32 32 32 32 32 32 32 32 32 32 -80 -80 -80 -80 -80 -80 -80 32 32 32 32 32 32 -37 32 32 32 32 32 32 32 32 32 -37 
-37 32 32 32 32 32 32 32 32 32 32 32 32 32 32 32 32 32 32 32 32 32 32 32 32 32 32 32 32 32 32 32 32 32 32 32 32 32 32 -37 -37 -37 -37 -37 -37 -37 -37 -37 -37 -37 
-37 32 32 32 32 32 32 32 32 32 32 32 32 32 32 32 32 32 32 32 32 32 32 32 32 32 32 32 32 32 32 32 32 32 32 32 32 32 32 -37 32 32 32 32 32 32 32 32 32 -37 
-37 32 32 32 32 32 32 32 32 32 32 32 32 32 32 32 32 32 32 32 32 32 32 32 32 32 32 32 32 32 32 32 32 32 32 32 32 32 32 -37 32 32 32 32 32 32 32 32 32 -37 
-37 32 32 32 32 32 32 32 32 32 32 32 32 32 32 32 32 32 32 32 32 32 32 32 32 32 32 32 32 32 32 32 32 32 32 32 32 32 32 -37 32 32 32 32 32 32 32 32 32 -37 
-37 32 32 32 32 32 32 32 32 32 32 32 32 32 32 32 32 32 32 32 32 32 32 32 32 32 32 32 32 32 32 32 32 32 32 32 32 32 32 -37 32 32 32 32 32 32 32 32 32 -37 
-37 32 32 32 32 32 32 32 32 32 32 32 32 32 32 32 32 32 32 32 32 32 32 32 32 32 32 32 32 32 32 32 32 32 32 32 32 32 32 -37 32 32 32 32 32 32 32 32 32 -37 
-37 32 32 32 32 32 32 32 32 32 32 32 32 32 32 32 32 32 32 32 32 32 32 32 32 32 32 32 32 32 32 32 32 32 32 32 32 32 32 -37 32 32 32 32 32 32 32 32 32 -37 
-37 32 32 32 32 32 32 32 32 32 32 32 32 32 32 32 32 32 32 32 32 32 32 32 32 32 32 32 32 32 32 32 32 32 32 32 32 32 32 -37 32 32 32 32 32 32 32 32 32 -37 
-37 32 32 32 32 32 32 32 32 32 32 32 32 32 32 32 32 32 32 32 32 32 32 32 32 32 32 32 32 32 32 32 32 32 32 32 32 32 32 -37 32 32 32 32 32 32 32 32 32 -37 
-37 32 32 32 32 32 32 32 32 32 32 32 32 32 32 32 32 32 32 32 32 32 32 32 32 32 32 32 32 32 32 32 32 32 32 32 32 32 32 -37 32 32 32 32 32 32 32 32 32 -37 
-37 32 32 32 32 32 32 32 32 32 32 32 32 32 32 32 32 32 32 32 32 32 32 32 32 32 32 32 32 32 32 32 32 32 32 32 32 32 32 -37 32 32 32 32 32 32 32 32 32 -37 
-37 -37 -37 -37 -37 -37 -37 -37 -37 -37 -37 -37 -37 -37 -37 -37 -37 -37 -37 -37 -37 -37 -37 -37 -37 -37 -37 -37 -37 -37 -37 -37 -37 -37 -37 -37 -37 -37 -37 -37 -37 -37 -37 -37 -37 -37 -37 -37 -37 -37 
